eth_sent,eth_received,num_sent_txs,num_received_txs,total_txs,address
215.30480013,0.0,48,0,48,0xd551234ae421e3bcba99a0da6d736074f22192ff
15.675105238208673,4.047736745248949,342,51,393,0xbe6aca3decc4b7e756addf8f24a174f5596ae1a8
113.23443336,0.0,40,0,40,0x564286362092d8e7936f0549571a803b203aaced
1.131092797459822,0.2589258468332738,21,11,32,0x160f713d638f7c849f807b97c6b71a3581b01dc3
0.051563696,0.0,1,0,1,0x417c058bb654d672f65686753d31466a3fc31504
0.0165609263605314,0.0,1,0,1,0x7da582385d10e5ff808b5ca86efdfa98dc85e2de
380.81854021000004,0.0,320,0,320,0x21a31ee1afc51d94c2efccaa2092ad1028285549
294.24562943,0.0,240,0,240,0x9696f59e4d72e237be84ffd425dcad154bf96976
0.741959267124385,0.1524698867056394,3,2,5,0x050d68c8078e46ca57c9c2bff589be2db1440040
0.119205422974829,0.0,1,0,1,0xf2c93c4fe4306b9d788275fda3c56a2d549ea97c
0.0743327515063651,0.078993,1,1,2,0xaa94b125c2562fc188f33c27e50c5405c6ca6946
443.4285291300001,0.0,58,0,58,0xa7efae728d2936e78bda97dc267687568dd593f3
0.0157190709834847,0.0,1,0,1,0x752a85ff94a2169edca2493c08b3bcb7dd5c876a
0.49190100999999997,0.0,4,0,4,0x4b4e14a3773ee558b6597070797fd51eb48606e5
5.4544010000000025,11.700957000000605,25,67,92,0xe4edb277e41dc89ab076a1f049f4a3efa700bce8
281.1563494699999,0.0,52,0,52,0xf7858da8a6617f7c6d0ff2bcafdb6d2eedf64840
2785.09719086,88.48972635484162,110,198,308,0xf89d7b9c864f589bbf53a82105107622b35eaa40
174.90205128999995,0.0,95,0,95,0x0d0707963952f2fba59dd06f2b425ace40b492fe
13.34171331333068,317.70315141139173,91,84,175,0x75e89d5979e4f6fba9f97c104c2f0afb3f1dcb88
0.6288882099999998,0.4021140074232578,15,17,32,0x2fc617e933a52713247ce25730f6695920b3befe
30.349568201292694,0.0567308016996215,279,13,292,0xf70da97812cb96acdf810712aa562db8dfa3dbef
0.0,0.0,0,11205,11205,0xdac17f958d2ee523a2206206994597c13d831ec7
0.0,0.02,0,29,29,0x111111125434b319222cdbf8c261674adb56f3ae
0.0,0.0,0,207,207,0x6b175474e89094c44da98b954eedeac495271d0f
0.0,1091.941335759052,0,5480,5480,0x7a250d5630b4cf539739df2c5dacb4c659f2488d
0.0,0.0,0,4,4,0xb91b439ff78531042f8eaaecaa5ecf3f88b0b67c
0.0,4.676071590936552,0,2,2,0x75116bd1ab4b0065b44e1a4ea9b4180a171406ed
0.0,0.0,0,4,4,0x0000000000004946c0e9f43f4dee607b0ef1fa1c
0.0,4.934004,0,2,2,0xfca5824f4af29f9509855bc31c7ec8d93a8d63ca
0.0,0.0,0,5741,5741,0xa0b86991c6218b36c1d19d4a2e9eb0ce3606eb48
0.0,0.0,0,5,5,0x8c412a045dd7546f7f44fec5fcaf1f38ca10e66b
0.0,0.0,0,3,3,0xe295ad71242373c37c5fda7b57f26f9ea1088afe
0.0,0.0,0,115,115,0x111111111117dc0aa78b770fa6a738034120c302
0.0,0.0,0,6,6,0x2c6264619d2f598a003d1c857e46edb95b22c75c
0.0,0.0,0,4,4,0x94bc2a1c732bcad7343b25af48385fe76e08734f
0.0,0.0,0,6,6,0x9509665d015bfe3c77aa5ad6ca20c8afa1d98989
0.0,34.39571388986319,0,455,455,0xdef1c0ded9bec7f1a1670819833240f027b25eff
0.0,0.0,0,1,1,0xd3cf4e98e1e432b3d6ae42ae406a78f2ac8293d0
0.0,0.0,0,3,3,0xa09d1afae21bda81c06fd6de9bbd7c7ed7b6dfb1
0.0,0.0,0,10,10,0xa0446d8804611944f1b527ecd37d7dcbe442caba
0.0,0.0,0,2,2,0x302a6eda4e2b2c563a80cc17bd80a1251b986677
0.0,0.052309828984634,0,1,1,0x5e7e51a5688e06e07b3bc0145e8ac44a2ed05cd7
0.0,285.76097099438874,0,879,879,0x881d40237659c251811cec9c364ef91dc08d300c
0.0,0.0,0,11,11,0x9f8f72aa9304c8b593d555f12ef6589cc3a579a2
0.0,0.0,0,2,2,0xf8f12fe1b51d1398019c4facd4d00adab5fef746
0.0,0.0,0,1,1,0xc545384331c78203a447b0b16268c14e0ad7a8d4
0.0,0.0,0,42,42,0x7d2768de32b0b80b7a3454c06bdac94a69ddc7a9
0.0,0.0,0,1,1,0x4ee7c0f5480eb1edd8902a5e8b991ed52992d5f5
0.0,0.0,0,1,1,0x0f85a912448279111694f4ba4f85dc641c54b594
0.0,0.0,0,3,3,0x6a58eb0d64974e7e76e8f1080e53db86e348bceb
0.0,0.0,0,2,2,0x10e6593cdda8c58a1d0f14c5164b376352a55f2f
0.0,0.0,0,2,2,0x74ee68a33f6c9f113e22b3b77418b75f85d07d22
0.0,0.4,0,1,1,0x043389f397ad72619d05946f5f35426a7ace6613
0.0,22.485051512686415,0,200,200,0xe592427a0aece92de3edee1f18e0157c05861564
0.0,0.0,0,11,11,0xa5409ec958c83c3f309868babaca7c86dcb077c1
0.0,0.38285,0,1,1,0x6683944e32c9903aab4f2a72e355122912ea3660
0.0,0.0,0,1,1,0xabc207502ea88d9bca29b95cd2eee5f0d7936418
0.0,342.2253157085877,0,1408,1408,0xc02aaa39b223fe8d0a0e5c4f27ead9083c756cc2
0.0,0.146458,0,4,4,0x8887710e1ccd9996307c900d34b585cff6ca586a
0.0,0.02253,0,1,1,0xae374e91540c15b07de4d4403ef34463bb47432c
0.0,0.0,0,2,2,0x068af1ec336344cd122b9811ef90d2384519005f
0.0,0.0,0,3,3,0x5bd25d2f4f26bc82a34de016d34612a28a0cd492
0.0,0.064,0,1,1,0xf78765bd14b4e8527d9e4e5c5a5c11a44ad12f47
0.0,0.0,0,1,1,0xf92cdb7669a4601dd76b728e187f2a98092b6b7d
0.0,0.0,0,1,1,0xf17e65822b568b3903685a7c9f496cf7656cc6c2
0.0,0.02684,0,1,1,0x737901bea3eeb88459df9ef1be8ff3ae1b42a2ba
0.0,0.0,0,1,1,0x41e3d4b3a79e464f65fffe18aa063de983ef97de
0.0,3.2912,0,30,30,0x5fdcca53617f4d2b9134b29090c87d01058e27e9
0.0,0.0,0,3,3,0xc5102fe9359fd9a28f877a67e36b0f050d81a3cc
0.0,81.31066214591135,0,392,392,0x00000000006c3852cbef3e08e8df289169ede581
0.0,28.678376999999998,0,50,50,0x1111111254fb6c44bac0bed2854e76f90643097d
0.0,0.09290042813227549,0,5,5,0x52ec2f3d7c5977a8e558c8d9c6000b615098e8fc
0.0,1.5927660000000001,0,15,15,0xff1f2b4adb9df6fc8eafecdcbf96a2b351680455
0.0,32.14319097160887,0,63,63,0x663dc15d3c1ac63ff12e45ab68fea3f0a883c251
0.0,0.49,0,1,1,0x1e2a36598ae22d5a8ea77e941d109a7d05384651
0.0,0.1333483556911932,0,2,2,0xe2e3441004e7d377a2d97142e75d465e0dd36af9
0.0,0.006633699999999999,0,3,3,0x5bf5bcc5362f88721167c1068b58c60cad075aac
0.0,0.0,0,63,63,0xe42cad6fc883877a76a26a16ed92444ab177e306
0.0,0.199,0,4,4,0x9d9ae1ad49be9b085fef04b9c835d484a6d099e3
0.0,0.0136143514997054,0,5,5,0x45704edabe7d2e038c35876dd3b6789511e452cf
0.0,1.5238161970492938,0,195,195,0x283af0b28c62c092c9727f1ee09c02ca627eb7f5
0.0,0.0,0,15,15,0x084b1c3c81545d370f3634392de611caabff8148
0.0,8.922554150435188,0,55,55,0xabea9132b05a70803a4e85094fd0e1800777fbef
0.0,0.02,0,15,15,0x07ced903e6ad0278cc32bc83a3fc97112f763722
0.0,0.0,0,2,2,0x914643668d83c1eeef33fd8286bf514a9dea498e
0.0,0.00777,0,10,10,0xd4307e0acd12cf46fd6cf93bc264f5d5d1598792
0.0,0.004829999999999999,0,8,8,0x84162fe2e695fedbf4d3bca1c3458fb616e44735
0.0,0.010878,0,5,5,0x21b589e8ad9efcd3582eac5de321d06def182e0f
20.455669000000018,11.4374010000008,71,89,160,0x80c67432656d59144ceff962e8faf8926599bcf8
0.0,2.8437999999999004,0,37,37,0x00000000000001ad428e4906ae43d8f9852d0dd6
0.0,0.019425,0,9,9,0xabba7d7f7f2e9eb818e7bd0c965f276b5b348fb9
0.0,0.003885,0,5,5,0x1645787ddcb380932130f0d8c22e6bf53a38e725
0.0,177.55017860338873,0,2004,2004,0x1111111254eeb25477b68fb85ed929f73a960582
0.0,14.57229928380384,0,58,58,0xae0ee0a63a2ce6baeeffe56e7714fb4efe48d419
0.0,0.0241428262176507,0,4,4,0x0a9f824c05a74f577a536a8a0c673183a872dff4
0.0,31.86207994344446,0,87,87,0x32400084c286cf3e17e7b677ea9583e60a000324
0.0,0.0,0,1,1,0x935442af47f3dc1c11f006d551e13769f12eab13
0.0,0.0,0,10,10,0x5f04d47d698f79d76f85e835930170ff4c4ebdb7
0.0,0.0,0,18,18,0x0000000000664ceffed39244a8312bd895470803
0.0,0.45053800000000005,0,38,38,0x1a0ad011913a150f69f6a19df447a0cfd9551054
0.0,0.0,0,1,1,0x58adf9953e5a2d175a15dc5807aca3520bf46cb3
0.0,0.0,0,3,3,0x7448c7456a97769f6cd04f1e83a4a23ccdc46abd
0.0,10.807937459175747,0,43,43,0xd19d4b5d358258f05d7b411e21a1460d11b0876f
0.0,0.0,0,1,1,0xfc8a98c22a9e32948ab028414d67c62c49b16864
0.0,0.0,0,14,14,0x932261f9fc8da46c4a22e31b45c4de60623848bf
0.0,0.0327,0,3,3,0x20f780a973856b93f63670377900c1d2a50a77c4
0.0,1.5435512784709802,0,19,19,0x735adbbe72226bd52e818e7181953f42e3b0ff21
0.0,0.26292976084799863,0,105,105,0x253553366da8546fc250f225fe3d25d0c782303b
0.0,0.0,0,11,11,0x9234f83473c03be04358afc3497d6293b2203288
0.0,0.0,0,13,13,0xc71b5f631354be6853efe9c3ab6b9590f8302e81
0.0,10.248572488899999,0,124,124,0x00000000000000adc04c56bf30ac9d3c0aaf14dc
0.0,0.0,0,9,9,0x0baeccd651cf4692a8790bcc4f606e79bf7a3b1c
0.0,9.328300539671984,0,41,41,0x6774bcbd5cecef1336b5300fb5186a12ddd8b367
0.0,0.00159,0,3,3,0xb4e7b8946fa2b35912cc0581772cccd69a33000c
0.0,111.88569603223301,0,972,972,0x0000000000000068f116a894984e2db1123eb395
0.0,0.8429999999999999,0,11,11,0x1f75881dc0707b5236f739b5b64a87c211294abb
0.0,0.02013867903441045,0,5,5,0xba5e35e26ae59c7aea6f029b68c6460de2d13eb6
0.0,9.191400000000002,0,6,6,0x0ec68c5b10f21effb74f2a5c61dfe6b08c0db6cb
0.0,0.0,0,2,2,0x0a32372381ea32a441d46553f879e4de7027b011
0.0,0.0,0,2,2,0xd784927ff2f95ba542bfc824c8a8a98f3495f6b5
0.0,0.0,0,50,50,0x4da27a545c0c5b758a6ba100e3a049001de870f5
0.0,0.0,0,40,40,0x7fc66500c84a76ad7e9c93437bfc5ac33e2ddae9
0.0,370.9676023162886,0,581,581,0x111111125421ca6dc452d289314280a0f8842a65
0.0,2.3213000000000004,0,6,6,0xcf5ea1b38380f6af39068375516daf40ed70d299
0.0,0.0,0,10,10,0xa35b1b31ce002fbf2058d22f30f95d405200a15b
0.0,0.0,0,1,1,0xbdea8e677f9f7c294a4556005c640ee505be6925
0.0,0.0,0,3,3,0x652329cc4f00af06a8020b41846d54a439a64620
0.0,0.0,0,2,2,0xc555d625828c4527d477e595ff1dd5801b4a600e
0.0,0.0,0,175,175,0x2260fac5e5542a773aa44fbcfedf7c193bc2c599
0.0,0.0,0,7,7,0x8bc93498b861fd98277c3b51d240e7e56e48f23c
0.0,4.844e-15,0,1,1,0x7a08b155ff182874a93c1403f4295e3dc3f314c4
0.0,0.0,0,1,1,0x56889e6f1b1e31040c5d0603abc34fc1d5611f98
0.0,0.0,0,84,84,0x4d224452801aced8b2f0aebe155379bb5d594381
0.0,9.7939643334272e-05,0,3,3,0x5182fede730b31a9cf7f49c5781214b4a99f2370
0.0,0.02256836509876,0,5,5,0x198cf9a9222d965475c4575e97ce42174c9f55f1
0.0,0.6688500000000002,0,12,12,0x2b08d7cf7eaff0f5f6623d9fb09b080726d4be11
0.0,0.028341841049415402,0,6,6,0x303a465b659cbb0ab36ee643ea362c509eeb5213
0.0,0.0,0,8,8,0x5c5b196abe0d54485975d1ec29617d42d9198326
0.0,15.14599490211477,0,242,242,0xa5f565650890fba1824ee0f21ebbbf660a179934
0.0,0.0,0,23,23,0xde30da39c46104798bb5aa3fe8b9e0e1f348163f
0.0,0.0,0,5,5,0xcc90105d4a2aa067ee768120ada19886021df422
0.0,0.683572,0,56,56,0x00005ea00ac477b1030ce78506496e8c2de24bf5
0.0,0.000402893261416013,0,13,13,0xaaaaaaae92cc1ceef79a038017889fdd26d23d4d
0.0,0.3454014678489633,0,24,24,0xeeeeee9ec4769a09a76a83c7bc42b185872860ee
0.0,0.0,0,7,7,0xc059a531b4234d05e9ef4ac51028f7e6156e2cce
0.0,0.0,0,51,51,0x26d85a13212433fe6a8381969c2b0db390a0b0ae
0.0,0.002813024811116457,0,14,14,0x4cd00e387622c35bddb9b4c962c136462338bc31
